Korean verbs
공부해	lernen
운동해요	Sport machen
축구해요	Fußball spielen
전화해요	telefonieren
일해요	Arbeit machen
노래해요	singen
게임해요	(Online-/Video-)Spiele spielen
일해요	Arbeit machen
쇼핑해요	shoppen
컴퓨터해요	etw. am Computer machen
요리해요	kochen
식사해요	eine Mahlzeit machen, essen
청소해요 	sauber machen, aufräumen
여행해요 	reisen, verreisen
데이트해요 	daten
회의해요 	ein Meeting haben
미팅해요 	ein Blind Date haben
시작해요 	starten, beginnen
끝나다-끝나요 	enden
이사해요 	umziehen(Wohnung)
연습해요 	üben
준비해요 	sich vorbereiten, ready
낚시해요 	angeln
운전해요 	ein Auto fahren
질문해요 	fragen
대답해요 	antworten
생각해요 	denken, überlegen
걱정해요 	Sorge machen, sich sorgen
얘기해요 	sprechen
말해요	sprechen
이야기해요	sprechen
한국말(을) 해요 	Koreanisch sprechen
사용해요 	benutzen
선택해요 	auswählen
후회해요 	bereuen
주문해요 	bestellen
좋아해요 	mögen, gern haben (*nicht trennbar!)
텔레비전을 봐요	TV schauen
빵을 먹어요 	ein Brot essen
책을 읽어요 	ein Buch lesen
신문을 읽어요 	eine Zeitung lesen
마셔요 	trinken
일어나요 	aufstehen
자요 	schlafen
가요 	(hin-)gehen, fahren, fliegen
와요	(hin-)kommen, fahren
살아요 	wohnen, leben
써요 	schreiben, aufsetzen, benutzen
친구를 만나요 	treffen
 음악을 들어요 	Musik hören
그림을 그려요 	Zeichnung zeichnen
춤을 춰요 	den Tanz tanzen
테니스를 쳐요 	Tennis spielen
 스키를 타요	Ski fahren
 버스를 타요	Bus fahren
내려요 	aussteigen
배워요 	lernen
가르쳐요	beibringen, unterrichten, lehren
사요 	kaufen
팔아요 	verkaufen
줘요 	geben
받아요 	nehmen, bekommen
친구를 기다려요	auf Freunde warten
찾아요 	suchen, finden
사진을 찍어요 	ein Foto machen
알아요 	wissen, kennen, verstehen
몰라요 	nicht wissen/kennen
괜찮아요 	okay/in Ordnung sein
만들어요 	basteln, herstellen, kochen, backen, schaffen, to make sth.
가져가요 	mitnehmen (Sachen)
가져와요	mitbringen (Sachen)
데려가요 	mitnehmen (Personen)
데려와요 	mitbringen (Person)
담배를 피워요 	Zigaretten rauchen
열어요 	öffnen, aufmachen
닫아요 	schließen, zumachen
닦아요 	Zähne putzen
불을 켜요	Licht anmachen, einschalten
꺼요 	ausschalten
불을 꺼요 	Licht ausschalten
쉬어요 	sich ausruhen
놀아요 	spielen, mit jemandem abhängen
빌려요 	ausleihen
