Korean Countries
한국	Korea
독일	Deutschland
일본	Japan
영국	England
중국	China
프랑스	France
태국	Thailand
이탈리아	Italien
대만	Taiwan
스위스	Schweiz
베트남	Vietnam
포르투갈	Portugal
필리핀	Philippinen
오스트리아	Austria
인도네시아	Indonesia
폴란드	Poland
인도	India
스페인	Spain
싱가포르	Singapour
네덜란드	Netherlands
몽골	Mongolia
스웨덴	Sweden
미국	USA
핀란드	Finnland
캐나다	Canada
노르웨이	Norwegen
터키	Türkei
이라크	Iraq
러시아	Russia
모로코	Marokko
호주	Australien
그리스	Greece
헝가리	Ungarn
체코	Tschechien
